EDEEEEEEEE
WWWWWWEWWW
EEEEEEEEEE
EWWWWEWWWW
EWEEEEEEEA
EWEEWWWEEE
EWEEWEWEWE
EWEWWEWEEE
EWEEWEEEEE
EEWWWWWWWW