EDEEEEEEEE
EWWWWWWEWW
EWEEEEEEEE
EWWWWEWWWW
EWEEEEWEEE
EWEEWWWEEE
EWEEWEWEAE
EWEWWEWEEE
EWEEWEEEEE
EEWWWWWWWW