EDEEEEEEEE
WWWWWWEWWW
EEEEEEEEEE
EWWWWEWWWW
EWEEEEEEEE
EWEEWWWEEE
EWEEWEWEAE
EWEWWEWEEE
EWEEWEEEEE
EEWWWWWWWW